1111111
1E00001
1010011
1010011
1P00001
100C001
1111111